2 0 0 1 30021 1 1 1 1 1
0 0 0 1 1 1 1 211 1 1
0 0 0 1 100031 1 1 1 1 1
1 1 1 1 1 1 1 1 1 1
1 311 1 1 1 1 1 1 200031 1
1 1 1 1 1 20021 1 1 1 1
30021 1 1 1 1 1 1 1 1 1
1 1 111 1 1 1 1 1 411 1
1 1 1 1 1 300031 1 1 1 1
1 1 1 1 1 1 1 1 1 1